+++++++++++
+    +    +
+ ><V V>< +
+ ^  +  > +
+ >  +    +
++ +++++ ++
+ >  +  < +
+ V  +  V +
+ ><^ ^>< +
+    +    +
+++++++++++