+++++++++++
+    +    +
+ LL   LL +
+ LL + LL +
+    +    +
++ +++++ ++
+    +    +
+ LL + LL +
+ LL   LL +
+    +    +
+++++++++++
