+++++++++++
+    +    +
+ LL   LL +
+ L  +  L +
+    +    +
++ +++++ ++
+    +    +
+ L  +  L +
+ LL   LL +
+    +    +
+++++++++++
