+++++++++++
+    +    +
+         +
+    +    +
+    +    +
++ +++++ ++
+    +    +
+    +    +
+         +
+    +    +
+++++++++++
